 
           F 	       0     ,          225    , 225
	SO	./textures/greystone.xpm


EA ./textures/red.xpm
 	 

	C 255,20,30
			 WE ./textures/purplestone.xpm

NO      ./textures/eagle.xpm

11111111111111111111111
10000000000000000001
10000000000000000001
10000000001000000001
10000000000000000001  1
1000000000N000000001
10000000000000000001
10000010000000000011111111111
100001 1000000000001
10000010000000000001
10000000000000000001
1111111111111111111
1111111111111111111
