F 95,65,2
C 28,1,69
NO ./textures/stone17.xpm
SO ./textures/stone1.xpm
EA ./textures/stone4.xpm
WE ./textures/stone10.xpm
1111111111111111111
1000001000000000001
1110000000000000111111111111
1000000000000000000000000111
111111000000N00000000000011
11110000000000000011111111111111
  111111111000000000001 1
     111111111111111111111 
