            F 	      220      ,          66    , 185
SO	./textures/greystone.xpm


EA ./textures/red.xpm
NO      ./textures/eagle.xpm
	 WE ./textures/purplestone.xpm

 	 C 255,20,30

11111111111111111111
10000000000000000001
10000000000000000001
10000000000000000001
10000000000000000001
1000000000N000000001
10000000000000000001
10000000000000000001
10000000000000000001
10000000000000000001
10000000000000000001
1111111111111111111111111111111
