 
           F 	       255     ,          225    , 50     
	SO	./textures/stone1.xpm


EA ./textures/stone4.xpm
 	 

	C 205,66,156                		
			 WE ./textures/stone10.xpm

NO      ./textures/stone17.xpm

11111111111111111111111
10000000000000000001
10010000000000000001
10000000001000000001                           1
10000000000000000001 1
1000000000N000000001
10000000000000000001
10000010000000000011111111111
100001 1000000000001
10000010000000000001
10000000000000000001
1111111111111111111
1111111111111111111
