F        3 ,   				145 , 25   

	  SO ./textures/wall_other.xpm		

			  EA      ./textures/wall_trou.xpm     			

                                 
WE     ./textures/wall_no_mouse.xpm


   			C     			29,6,   		75

					
NO ./textures/japwall.xpm
 111111111111111111111111111
10000000000000000000000000001
10010000000000000001111111101 
10000000001000000001      101                     1
10000000000000000001      101
10000000000000000001111111101111
10000000000000000000000000000001
10000010000000000011111111111101
100001 1000000000001  1      101
10000010000000000001 101     101
10000000000000000001  1      101
 111111111111111111111111111110111
                             100W1
                             11111  
   1111
                   1111
                     101
                      1
                                                 111            1


			

     
