F 0 , 255 , 0

SO ./textures/wall_other.xpm

EA ./textures/wall_trou.xpm

C 29,6,75

WE ./textures/wall_no_mouse.xpm

NO ./textures/japwall.xpm

1111111111111111111
1000001000000000001
1110000000000000111111111111
1000000000000000000000000111
111111000000W00000000000011
11110000000000000011111111111111
  111111111000000000001 1
     111111111111111111111 
