 
           F 	       220     ,          66    , 185
	SO          ./textures/greystone.xpm

EA ./textures/red.xpm
 	 
   
	C 255,20,30
			 WE ./textures/purplestone.xpm

NO      ./textures/eagle.xpm

                     
1111111111111111111111
  1000000000000000001
111100000000000000001
10000000001000000001
10000000000000000001  1  
10000000000E00001111
1000000000000001  
10000010000000001111111111111
100001 1000000000001
10000010000000000001
10000000000000000001
1111111111111111111




         
